WE ./resourses/blocks.xpm
NO ./resourses/pixil.xpm
SO ./resourses/blocks.xpm
EA    ./resourses/blocks.xpm

C      0,     0,     0     
F 255,255,255


1111111111111111111111111   
1000000000110000000000001
1011000001110000000000001        
100100000000001000000000111111111 
11111111101100N001110000000000001  
100000000011000001110111111111111
11110111111111011100000010001
11110111111111011101010010001
11000000110101011100000010001
1000010000000001100000010001
10000100000000001101010000001
110000011101010111110111100111
1111111 1110101 101111010001
1111111 1111111 111111111111
