NO ./resourses/pixil.xpm
SO ./resourses/blocks.xpm
WE ./resourses/blocks.xpm
EA ./resourses/blocks.xpm

C      128, 0, 128
F 255, 192, 203

1111111111111111111111111
1000000000000000000000001
1000000000000000000000001
1000000001000000000000001
1                       1
1000000000000000000000001
1000000001000000000000001
10000000N0100000000000001
1000001100000110000000001
1000000001000000000000001
1111111111111111111111111